111111111
10E001C01
1P0000C01
100000001
10C010001
10C010001
111111111